b,m,c,T,#variables,#constraints,socount,time
1,1,1,10,2,4,1,0.01186074
1,1,2,10,4,10,1,0.0045415
1,1,4,10,8,28,1,0.00580356
1,1,8,10,16,88,1,0.00720155
1,1,16,10,32,304,1,0.00674625
1,1,32,10,64,1120,1,0.02364387
1,1,64,10,128,4288,1,0.15990722
1,1,128,10,256,16768,1,1.86959475
1,1,256,10,512,66304,1,14.03314395
1,1,512,10,1024,263680,1,160.9501519
